/* Qwerty
 * ,-----------------------------------------------------------------------------------.
 * |   `  |   1  |   2  |   3  |   4  |   5  |   6  |   7  |   8  |   9  |   0  | Bksp |
 * |------+------+------+------+------+------+------+------+------+------+------+------|
 * | Esc  |   Q  |   W  |   E  |   R  |   T  |   Y  |   U  |   I  |   O  |   P  |  \   |
 * |------+------+------+------+------+-------------+------+------+------+------+------|
 * | Tab  |   A  |   S  |   D  |   F  |   G  |   H  |   J  |   K  |   L  |   ;  |  "   |
 * |------+------+------+------+------+------|------+------+------+------+------+------|
 * | Shift|   Z  |   X  |   C  |   V  |   B  |   N  |   M  |   ,  |   .  |   /  |Shift |
 * |------+------+------+------+------+------+------+------+------+------+------+------|
 * | Ctrl |  Fn  | Alt  | GUI  |Lower |Enter | Space| Raise|  Fn  | GUI |  RAlt | Ctrl |
 * `-----------------------------------------------------------------------------------'
 */

 /* Lower
 * ,-----------------------------------------------------------------------------------.
 * |      |      |      |      |      |      |      |      |      |      |      | Bksp |
 * |------+------+------+------+------+-------------+------+------+------+------+------|
 * |  Esc |      |   -  |   +  |   =  |      |      |   (  |   )  |   _  |   :  |  |   |
 * |------+------+------+------+------+-------------+------+------+------+------+------|
 * |      |      |   &  |   *  |   ~  |      |      |   {  |   }  |   [  |   ]  |      |
 * |------+------+------+------+------+------|------+------+------+------+------+------|
 * |      |      |   £  |   $  |   #  |      |      |      |      |      |      |      |
 * |------+------+------+------+------+------+------+------+------+------+------+------|
 * |      |      |      |      |      |      |      |      |      |      |      |      |
 * `-----------------------------------------------------------------------------------'
 */

 /* Raise
 * ,-----------------------------------------------------------------------------------.
 * |      |      |      |      |      |      |      |      |      |      |      | Bksp |
 * |------+------+------+------+------+------+------+------+------+------+------+------|
 * |  Esc | Back | PgUp |  Fwd |      |      |      | TabL |  Up  | TabR |      |      |
 * |------+------+------+------+------+-------------+------+------+------+------+------|
 * |      |      | PgDn |      |      |      |      | Left | Down | Right|      |      |
 * |------+------+------+------+------+------|------+------+------+------+------+------|
 * |      |      |      |      |      |      |      |      |      |      |      |      |
 * |------+------+------+------+------+------+------+------+------+------+------+------|
 * |      |      |      |      |      |      |      |      |      |      |      |      |
 * `-----------------------------------------------------------------------------------'
 */

 /* Fns
 * ,-----------------------------------------------------------------------------------.
 * |      |      |      |      |      |      |      |      |      |      |      |      |
 * |------+------+------+------+------+------+------+------+------+------+------+------|
 * |      |      |      |      |      |      |      |      | VolD | Mute | VolU |      |
 * |------+------+------+------+------+-------------+------+------+------+------+------|
 * |      |      |      |      |      |      |      |      | Prev | Play | Next |      |
 * |------+------+------+------+------+------|------+------+------+------+------+------|
 * |      |      |      |      |      |      |      |      |      |      |      |      |
 * |------+------+------+------+------+------+------+------+------+------+------+------|
 * |      |      |      |      |      |      |      |      |      |      |      |      |
 * `-----------------------------------------------------------------------------------'
 */